#########################
#@.................P...#
#.###.#.#.#.#.#.#.#.#..#
#.....#.....#.....#.#..#
#.###.#.#.#.#.#.#.#.#..#
#P....#.....#.....C.#..#
#.###.#.#.#.#.#.#.#.#..#
#.....#.....#.....#.#..#
#.###.#.#.#.#####C#.#..#
#.....#.....C...P.#.#..#
#.###.#.#.#.#####.#.#..#
#.....#.....#.......#..#
#.###.#.#.#.#.#####.#..#
#.....P..........E#.#..#
#########################