###############
#@..........P.#
#.###.#.#.#.#.#
#.....#.....#.#
#Ñ###.#.#.#.#.#
#.....C.....#.#
#.###.#.#.#.#.#
#.....#.....#.#
#.###.#.#.#..E#
###############